####################
#.................t#
#..................#
#......f...........#
#..................#
#...#..#..#..#..#..#
#..................#
#..................#
#..l...............#
#..................#
#..................#
#...............r..#
#....#.............#
#.....#............#
#....#.i...........#
#.....#........###.#
#..................#
#..................#
#..p...............#
####################