####################
#.t................#
#..................#
#..............i...#
#..................#
#..................#
#....r.............#
#..................#
#..............l...#
#..................#
#..................#
#..................#
#..................#
#.....#............#
#...d.#............#
#.....#............#
#..................#
#..................#
#............l.....#
####################