####################
#..................#
#...........####...#
#..i..........c#...#
#..............#...#
#..................#
#.......l..........#
#..................#
#..................#
#...#..............#
#...#.........i....#
#.r.#..............#
#...#..............#
#...###............#
#.....#............#
#..................#
#..................#
#..t...............#
#............l.....#
####################