####################
#.F................#
#..................#
#..............F...#
#..................#
#..................#
#....F.............#
#..................#
#..............F...#
#..................#
#..................#
#..................#
#..................#
#.....#............#
#...P.#............#
#.....#............#
#..................#
#..................#
#............F.....#
####################