####################
#..............l...#
#....i.............#
#..................#
#..................#
#..................#
#..................#
#..................#
#..................#
#..i...............#
#..................#
#..................#
#............l.....#
#..................#
#..................#
#..................#
#..................#
#..................#
#.p................#
####################