####################
#.............l....#
#..................#
#...#..............#
#....#.............#
#.....#............#
#......#...........#
#.......#..i.......#
#....c...#.........#
#........#.....#####
#........#.........#
#.......#..........#
#......#...........#
#.....#............#
#....#.............#
#...#...f........t.#
#....#.............#
#....#.............#
#.l................#
####################